TST = "countries/Test.txt"

UNC = "countries/UnitedCities.txt"
HLN = "countries/HolyNation.txt"
SHK = "countries/ShekKingdom.txt"

TDG = "countries/TradersGuild.txt"
SUC = "countries/Stormgap.txt"
SHN = "countries/HN_Seta.txt"
IHN = "countries/HN_Vindictus.txt"
VHN = "countries/HN_Valtena.txt"
HHN = "countries/HN_Harbinger.txt"
SSK = "countries/SouthShekArmy.txt"

KRC = "countries/KralsChosen.txt"
BOB = "countries/BandOfBones.txt"
BRS = "countries/BerserkerSouth.txt"
FSS = "countries/FreeShekState.txt"
BLB = "countries/BloodBrothers.txt"
STC = "countries/SteelChapter.txt"
DSP = "countries/DesolatePlunderers.txt"
FOL = "countries/ForsakenLeague.txt"
UFF = "countries/Unit45.txt"
ARG = "countries/ArachGuard.txt"
BUG = "countries/Bugmaster.txt"

SRR = "countries/SecondRedRebellion.txt"
XUC = "countries/SouthUC.txt"
MNH = "countries/Manhunters.txt"
FCC = "countries/Catun.txt"
RSB = "countries/RedSabres.txt"
SWN = "countries/SwampNinjas.txt"

WHO = "countries/SwampHounds.txt"
WPU = "countries/SwampPuritans.txt"
WGR = "countries/SwampGrayflayers.txt"
WTW = "countries/SwampTwinblades.txt"
WBL = "countries/SwampBlackshifters.txt"
WST = "countries/SwampStoneRats.txt"
WBE = "countries/SwampBandOfExiles.txt"
WCB = "countries/SwampColdBloods.txt"
SWA = "countries/SwampBase.txt"

WEH = "countries/WesternHive.txt"
MIH = "countries/MidlandHive.txt"

ZBD = "countries/BZ_BlackDragonNinjas.txt"
ZWE = "countries/BZ_WhiteEyebrowClan.txt"
ZDV = "countries/BZ_Doves.txt"
ZBH = "countries/BZ_BleedingHearts.txt"
ZHB = "countries/BZ_HungryBandits.txt"
ZCN = "countries/BZ_ChurchOfNarko.txt"
ZDB = "countries/BZ_DustBandits.txt"
ZRF = "countries/BZ_RedemptionFront.txt"
ZHH = "countries/BZ_HalfwayHive.txt"
ZSC = "countries/BZ_ShinobiClan.txt"
ZNM = "countries/BZ_Nameless.txt"
ZHO = "countries/BZ_HubOutlaws.txt"
ZOF = "countries/BZ_OkransFury.txt"
ZST = "countries/BZ_Stickton.txt"
ZVG = "countries/BZ_Vergers.txt"
ZWM = "countries/BZ_WildMen.txt"
ZFC = "countries/BZ_FortunesCall.txt"
ZGL = "countries/BZ_Greenleaf.txt"

FLO = "countries/Flotsam.txt"
HMU = "countries/HillMarauders.txt"
FLC = "countries/FlotsamCannibalHunters.txt"
DDC = "countries/Deadcat.txt"
CNW = "countries/CannibalsWest.txt"
CNE = "countries/CannibalsEast.txt"
XWE = "countries/TH_WorldsEnd.txt"
XBS = "countries/TH_BlackScratch.txt"
XFL = "countries/TH_FlatsLagoon.txt"
XMO = "countries/TH_Mourn.txt"
SOH = "countries/SouthernHive.txt"
SKB = "countries/SkinBandits.txt"
SEM = "countries/SecondEmpire.txt"
IMP = "countries/ImperialGuard.txt"

FRB = "countries/FarmersRebellion.txt"
SLP = "countries/SlaversPact.txt"
CWY = "countries/CastawayHive.txt"
CHT = "countries/CannibalHunters.txt"
FOG = "countries/Fogmen.txt"
MON = "countries/Mongrel.txt"
FSH = "countries/Fishmen.txt"

YDR = "countries/BAST_DuneRenegades.txt"
YGC = "countries/BAST_GoldenCircle.txt"
YFD = "countries/BAST_FortDrin.txt"
YNS = "countries/BAST_NatSalvArmy.txt"
YSS = "countries/BAST_SilverSabres.txt"
YOE = "countries/BAST_OrderOfTheEagle.txt"
YSU = "countries/BAST_Sullies.txt"
YCW = "countries/BAST_CarvendersWolves.txt"
YBH = "countries/BAST_BastHolyState.txt"
YNI = "countries/BAST_NovaImperita.txt"
YCC = "countries/BAST_ChitrinsCrusade.txt"

SMG = "countries/SmugglersGuild.txt"
SMN = "countries/ShemNomads.txt"
VNG = "countries/VengeThralls.txt"
DEX = "countries/DeadlandExiles.txt"
DLG = "countries/Deluged.txt"
BRN = "countries/BerserkerNorth.txt"
SNJ = "countries/SandNinjas.txt"
GOB = "countries/GorilloBandits.txt"

VBO = "countries/WILD_Bonefields.txt"
VIV = "countries/WILD_IronValleys.txt"
VOB = "countries/WILD_Obedience.txt"
VUW = "countries/WILD_UnwantedZone.txt"

ANS = "countries/AntiSlavers.txt"
COS = "countries/CultOfStobe.txt"
THB = "countries/TechHunterBandits.txt"
KLB = "countries/SkeletonBandits.txt"
CRD = "countries/CrabRaiders.txt"
REA = "countries/Reavers.txt"
GRP = "countries/GrassPirates.txt"
PDO = "countries/PreachersDomain.txt"
BDG = "countries/BlackDogClan.txt"
XTH = "countries/GreyDesertTH.txt"
BNJ = "countries/BlackDesertNinjas.txt"
BLR = "countries/Bloodraiders.txt"
AVA = "countries/Avalon.txt"

VGT = "countries/WILD_Gut.txt"
CHB = "countries/Chainbreakers.txt"
IHA = "countries/ImperialHiverArmy.txt"
SCM = "countries/Scumrakers.txt"
OGD = "countries/OldGuard.txt"
VSE = "countries/SoutheastWarzone.txt"
MCH = "countries/MechanicalHive.txt"

SNI = "countries/SniperLegion.txt"
ALP = "countries/MasterBastion.txt"
CUC = "countries/CentralUC.txt"
SBM = "countries/StobesBounty.txt"
KDR = "countries/KarateDrifters.txt"
SAH = "countries/Beakmaster.txt"

DSC = "countries/DisasterCrew.txt"
NWN = "countries/NWNomads.txt"
GOA = "countries/GoatHerders.txt"
VRP = "countries/WILD_RaptorIsland.txt"
SBN = "countries/ShriekingBandits.txt"
SKV = "countries/Skavengers.txt"
ILC = "countries/IronLibComm.txt"
BSM = "countries/BlossomClan.txt"
PRL = "countries/PearlRepublic.txt"
RWK = "countries/TheReawakened.txt"